00000000000001111111110000000000000
00000000000001000000010000000000000
00001000000000000000000000000010000
00000000000000000000000000000000000
00000000000000000000000000000000000
00001000000300000000000000000010000
00000000000000000000000000000000000
00000000900000000000000000000000000